012S021020120002102012
0210201021020120200212
2010210201021020120021
2012102201210212012010
0210210201201020120102
0102102012121212121212
0000002121212121212122
0202002020110100110101
1010201020120020022022
2121212122121212121221
0000001212120000212120
0212122121202121212000
2120102010200201201020
2120120120012002012212