///,......$.......,///
/,.....,//////.../////
//,,,,..////...../////
///,,,,,///.....//.../
///.....//.....///////
///...,....,..///...//
///..//,,...,,.,,//////
////../..,,,,,////////
/...../.....////....//
////......,.......,,.,
///,...........,//////
///........,...,//////
//................////
////,,,....../////////
//......,,,,,,,,//////
,,..................,/