///,......$.......,///
/,...,,,//////////////
//,,,,..//////////////
///,,,,,//////////////
///.....//////////////
//////,,,,,,//////////
//////,,.,,,,.,,//////
/////////,,,,,////////
//////////////////////
//////////////////////
//////////////////////
//////////////////////
//////////////////////
//////////////////////
//////////////////////
//////////////////////