///,......$.......,///
/,...,,,//////////////
//,,,,..//////////////
///,,,,,//////////////
///.....//////////////
//////,,,,,,//////////
//////,,.,,,,.,,//////
/////////,,,,,////////
///////.....//////////
////......,...////////
//////,........,//////
///........,...,//////
//................////
////,,,....../////////
////////,,,,,,,,//////
/,..................,/