///,......$.......,///
/,...,,,//////.../////
//,,,,..////...../////
///,,,,,///.....//.../
///.....//.....///////
//////,....,..///...//
//////,,...,,.,,//////
////.....,,,,,////////
///////.....////....//
////......,.../...,,.,
//////,........,//////
///........,...,//////
//................////
////,,,....../////////
//......,,,,,,,,//////
.,..................,/