///,......$.......,///
/,.....,//////.../////
//,,,,.%////...../////
///,,,,,///........../
///.....//.....//.%///
///...,....,..///...//
///..//,,...,,.,,..///
////../..,,,,,///...//
/%..../...,%////....//
////......,.......,%.,
///,......,....,//////
///.......,,...,//////
//................////
////,,,....../....////
//......,,,,,,,/...///
,,..................,/