///,......$.......,///
/,...,,,//////.../////
//,,,,..////...../////
///,,,,,///.....//.../
///.....//.....///////
//////,....,..///...//
//////,,.,,,,.,,//////
/////////,,,,,////////
///////.....//////////
////......,...////////
//////,........,//////
///........,...,//////
//................////
////,,,....../////////
////////,,,,,,,,//////
/,..................,/